2 4 3 3 3 3 3 D 3 3 3 3 3 3 3
2 . . . . . . . . . . . . . 2
2 . . . . . . . . . . . . . 2
2 . . . 4 . . . . . . . . . 2
2 . . . . . . . . . . 1 . . 2
5 . . . . . . . . . . . . . D
D . . . . . . . . . . . 1 1 2
D . . . . . A . . . 2 2 2 . 2
D . . . . . . . . . 2 . . . 2
2 . . 2 . . . . . P D . . . 2
2 . . . . . . . . . 2 . . . 2
2 4 3 3 3 3 D 4 3 3 3 3 3 3 2